111111111111111111111111111111111111111111111111111111111111111111111111111111
1P1111111111111111111111111111111111111111111111111111111111111111111111111011
101111111111111111111111111111111111111111111111111111111111111111111111111011
101111111111111111111111111111111111111111111111111111111111111111111111111011
101111111111111111111111111111111111111111111111111111111111111111111111111011
101111111111111111111111111111111111111111111111111111111111111111111111111011
101111111111111111111111111111111111111111111111111111111111111111111111111011
101111111111111111111111111111111111111111111111111111111111111111111111111011
101111111111111111111111111111111111111111111111111111111111111111111111111011
101111111111111111111111111111111111111111111111111111111111111111111111111011
101111111111111111111111111111111111111111111111111111111111111111111111111011
101111111111111111111111111111111111111111111111111111111111111111111111111011
101111111111111111111111111111111111111111111111111111111111111111111111111011
1011111111111111111E1111111111111111111111111111111111111111111111111111111011
101111111111111111001111111111111111111111111111111111111111111111111111111011
101111111000000000011111111111111111111111111111111111111111111111111111111011
101111111000011111111111111111111111111111111111111111111111111111111111111011
101111111000011111111111111111111111111111111111111111111111111111111111111011
101111111110111111111111111111111111111111111111111111111111111111111111111011
101000000000111111111111111111111111111111111111111111111111111111111111111011
101001111111111111111111111111111111111111111111111111111111111111111111111011
101001111111111111111111111111111111111111111111111111111111111111111111111011
10CCC1111111111111111111111111111111111111111111111111111111111111111111111011
11C111111111111111111111111111111111111111111111111111111111111111111111111011
11C111111111111111111111111111111111111111111111111111111111111111111111111011
11C111111111111111111111111111111111111111111111111111111111111111111111111011
1CCC11111111111111111111111111111111111111111111111111111111111111111111111011
11C111111111111111111111111111111111111111111111111111111111111111111111111011
11C111111111111111111111111111111111111111111111111111111111111111111111111011
11C111111111111111111111111111111111111111111111111111111111111111111111111011
11CCCCCCC000000000000000000000000CCCCCCCCCCCCCCCCCCCCCCCCCCCCCCCCCCCCCCCCCCCC1
111111111111111111111111111111111111111111111111111111111111111111111111111111