11111111111111111111111111
1P10CC1111CCC1100001100001
101C1C111101C1101101101101
101C1C0CC0C1C1001101101101
100C11111111CCC111000011E1
11111111111111111111111111