111111111111111111111111111111111111111111111111
10010000000C100000000000000000000000000000000001
100001110000100000000000000000000000000000000001
100001111100100000000000000000000000000000000001
100001111100100000000000000000000000000000000001
100001111100100000000000000000000000000000000001
100001111100100000000000000000000000000000000001
100001111100100000000000000000000000000000000001
100001111100000000000000000000000000000000000001
100001111100000000000000000000000000000000000001
100001111100100000000000000000000000000000000001
1P0011E00000100000000000000000000000000000000001
111111111011100000000000000000000000000000000001
100000C00000100000000000000000000000000000000001
111111111111111111111111111111111111111111111111